10 10
   #dd#   
  #....#  
 #......# 
#........#
d........d
d........d
#........#
 #......# 
  #....#  
   #dd#    
