12 12
    ####    
   #    #   
  #      #  
 #        # 
#          #
#          #
#          #
#          #
 #        # 
  #      #  
   #    #   
    ####     
