21 16
#####################
#     ###           #
#     ###       ##  #
#     #####  #      #
#   ######  ##      #
# #  ####  ##########
# ##  ##  ##        #
# ###               #
# ####  ####        #
#  ##  ## ########  #
##    ##    ###     #
###  #### # ###     #
##  ####### ###  #  #
#  ######        #  #
#          ####     #
#####################
