###############      
# #######     #      
#  ######     #      
#  ########  ##      
#   ######  ###      
# #  ####  ##########
# ##  ##  ##        #
# ###               #
# ####  ####        #
#  ##  ## ###########
##    ##    ###      
###  #### # ###      
##  ####### ###      
#  ######     #      
#          ####      
###############      
